24			24
190			100
0			0			0			0			0			0			0			0			0			0			0			0			0			0			0			0			0			0			0			0			0			0			0			0
0			6			3			3			3			3			3			3			3			3			3			3			3			3			3			3			3			3			3			3			3			3			7			0
0			5			1			1			1			1			1			1			1			1			1			1			1			1			1			1			1			1			1			1			1			1			4			0
0			5			1			1			1			1			1			1			1			1			1			1			1			1			1			1			1			1			1			1			1			1			4			0
0			5			1			1			1			1			1			1			1			1			1			1			1			1			1			1			1			1			1			1			1			1			4			0
0			5			1			1			1			1			1			1			1			1			1			1			1			1			1			1			1			1			1			1			1			1			4			0
0			5			1			1			1			1			1			1			1			1			1			1			1			1			1			1			1			1			1			1			1			1			4			0
0			5			1			1			1			1			1			1			1			1			1			1			1			1			1			1			1			1			1			1			1			1			4			0
0			5			1			1			1			1			1			1			1			1			1			1			1			1			1			1			1			1			1			1			1			1			4			0
0			5			1			1			1			1			1			1			1			1			1			1			1			1			1			1			1			1			1			1			1			1			4			0
0			5			1			1			1			1			1			1			1			1			1			1			1			1			1			1			1			1			1			1			1			1			4			0
0			5			1			1			1			1			1			1			1			1			1			1			1			1			1			1			1			1			1			1			1			1			4			0
0			5			1			1			1			1			1			1			1			1			1			1			1			1			1			1			1			1			1			1			1			1			4			0
0			5			1			1			1			1			1			1			1			1			1			1			1			1			1			1			1			1			1			1			1			1			4			0
0			5			1			1			1			1			1			1			1			1			1			1			1			1			1			1			1			1			1			1			1			1			4			0
0			5			1			1			1			1			1			1			1			1			1			1			1			1			1			1			1			1			1			1			1			1			4			0
0			5			1			1			1			1			1			1			1			1			1			1			1			1			1			1			1			1			1			1			1			1			4			0
0			5			1			1			1			1			1			1			1			1			1			1			1			1			1			1			1			1			1			1			1			1			4			0
0			5			1			1			1			1			1			1			1			1			1			1			1			1			1			1			1			1			1			1			1			1			4			0
0			5			1			1			1			1			1			1			1			1			1			1			1			1			1			1			1			1			1			1			1			1			4			0
0			5			1			1			1			1			1			1			1			1			1			1			1			1			1			1			1			1			1			1			1			1			4			0
0			5			1			1			1			1			1			1			1			1			1			1			1			1			1			1			1			1			1			1			1			1			4			0
0			5			1			1			1			1			1			1			1			1			1			1			1			1			1			1			1			1			1			1			1			1			4			0
0			0		1:32:wt		1:32:wt		1:32:wt		1:32:wt		1:32:wt		1:32:wt		1:32:wt		1:32:wt		1:32:wt		1:32:wt		1:32:wt		1:32:wt		1:32:wt		1:32:wt		1:32:wt		1:32:wt		1:32:wt		1:32:wt		1:32:wt		1:32:wt		0			0